┌ ───────────┬─┬─┬────┐
│            │ │ │    │
│   ─────────┤ │ │  │ │
├─┐          │   │  │ │
│ │   ┌─────   │ │  │ │
│ │   │        │ │ㅇ│ │
│ │   │ ─────┐ │ │  │ │
│ │   │      │ │ │  │ │
│ │   └──────┤ │ ├──┤ │
│            │ │ │  │ │
├────┐  ┌─┬──┘ │ │  │ │
│    │  │ │         │ │
│ ───┘  │ │ ──┴─────┘ │
│                     │
└─────────────────────┘
